------S---
------S-N-
---S--S---
---S------
---S------
X
P 1,1